-11
12
-3
5
000000000000000000000000
000000000000000000000110
000000000000001111111000
100000000000001111111000
000000000000001111111000
001000000000001111111000
000000000000001111111000
000000000000001111111000
000000000000001111111000
